1111111111
1000000001
1011101011
1000100011
1110111001
1000000001
1011111011
1000010001
1111111111

