1111111111
1000000201
1011101011
1000102011
1110111001
1020000001
1011111011
1002010001
1111111111

